111111111111111111111111111111
1CCCCCCCCCCCC1111CCCCCCCCCCCC1
1C1111C11111C1111C11111C1111C1
1C1111C11111C1111C11111C1111C1
1C1111C11111C1111C11111C1111C1
1CCCCCCCCCCCCCCCCCCCCCCCCCCCC1
1C1111C11C1111111111C11C1111C1
1C1111C11C1111111111C11C1111C1
1C1111C11CCCC1111CCCC11C1111C1
11111C11111C111111C11111C11111
11111C11111C111111C11111C11111
11111C11CCCCCMCCCCCCCC11C11111
11111C11C111101111111C11C11111
11111C11C1111E1111111C11C11111
11111C11C111111111111C11C11111
11111C11CCCCCCCCCCCCCC11C11111
11111C11C111111111111C11C11111
11111C11C111111111111C11C11111
1CCCCCCCCCCCC1111CCCCCCCCCCCC1
1C1111C11111C1111C11111C1111C1
1C1111C11111C1111C11111C1111C1
1CCC11CCCCCCCCCCCCCCCCCC11CCC1
111C11C11C1111111111C11C11C111
111C11C11CCCC1111CCCC11C11C111
1CCC11C11C1111111111C11C11CCC1
1CCCCCCCPCCCCCCCCCCCC11C11CCC1
1C11111111111111111111111111C1
1C11111111111111111111111111C1
1CCCCCCCCCCCCCCCCCCCCCCCCCCCC1
111111111111111111111111111111