111111111111111111111111111111111111111111
11111E0000000000M0000000000000000000011111
111110000000000000000000000000000000011111
111110000000000000000000000000000000011111
111111111111111110000000111111111111111111
100000000000001110000000111100000000000001
1111111111111111100C0000111111111111111111
100000000000000000000000000000000000000001
100000000000000000000000000000000000000001
1000111111110000000C0000000000111111110001
100011111111000000000000000000111111110001
100011000011111111110011111111110000110001
100011000000000000000000000000000000110001
100011000011111111110011111111110000110001
1000111111110P0000000000000000111111110001
100011111111000000000000000000111111110001
100000000000000000000000000000000000000001
100000000000000000000000000000000000000001
111111111111111111111111111111111111111111